mass media : Massenmedien
tech-savvy : Mit Technikerfahrung
24/7 : Rund um die Uhr
ubiquitous : allgegenweartig
inextricable : untrennbar
portable : tragbar
showcase : Schaukasten,Vitrine
narcissistic : narzisstisch,selbstverliebt
account : Konto
DIY : zum Selbermachen
dissemination : Verbreitung
circulation : Umlauf,Auflage
to craft : (von Hand) fertigen
censorship : Zensur
to plagiarize : plagiieren
infrigement : Rechtsverletzung,Verstoss
deception : Teauschung,Betrug
capable : feahig
repressive : unterdruckerisch,repressiv
to trace : ausfindig machen
villain : Beosewicht,Schurke
to mess around : herumalbern
to accomplish : erreichen,leisten
vendetta : (Blut)rache
to mock-up : nachahmen
narcissist : Narzisst/in
vanity : Eitelkeit
self-absorbed : egozentrisch,ichbezogen
prevalence : Vorherrschaft,Heaufigkeit
correlation : Zusammenhang
affirmation : Besteatigung
self-esteem : Selbstwertgefeuhl
layer : Schicht
to erase : leoschen,ausradieren